%%%%%
%  .%
%   %
%1  %
%%%%%
